CCCCCACLCCCLCLLLCCCC
CCCCCCCCCCCCCLCICCCC
CCCCCACCCIICCLCLCCCC
LCCCLALLLIILLLCLCCCC
CCCCLACLLLLLCCCCCLLC
IICCLAAACAAAAAIICLLC
CCCCCCCCCCBBLALLLLLC
CCCCCLLCCCBBCACCCLLC
LLLCLLLCIBBBBACCCLLC
LLLCLLLCIBBBBACCCIII
LLCCLLLCLLBBLACCCCCC
CCCCLLLCLLBBLACCLLLL
CLLCCCCCLCLLLACCLLCC
CLLLLLLCLLLLLACLLLCC
CLLLLLLCLLLLLACCBBCC
CLLIIIICLLLLLACCBBCC
CLLLIIICCCCCLLBBBBBB
CCCCCCCCIEICIACCBBCC