LLLLLACLCCCLCLLLCCCC
LLLCCCCCCCCCCLCICCCC
LLCCCCCCCIICCLCICCCC
LLCCCACLLIILLLCLCCCC
LCCCCACCCLLLCCCCCLLC
LCCCCAAACAAAAAIICLLC
LCCCCCCCCCBBLALLLLLC
LLLCCLLCCCBBCACCCLLC
LLLCLLLCIBBBBACCCLLC
LLLCLLLCIBBBBACCCIII
LLCCLLLCICBBCACCCCCC
CCCCLLLCICBBCACCLLLL
CLLCCCCCCCCCCACCLLCC
CLLLLLLCLLLLLACLLLCC
CLLLLLLCLLLLLACCBBCC
CLLIIIICLLLLLLCCBBCC
CLLLCCCCCCCCLLBBBBBB
CCCLCCCCCCCCLLBBBBBB
CCCCCCCCLLLCCACCBBCC
LLLCCCCCLELCIACCBBCC